...................................
...................................
......X.................X..........
......X..................X.........
......X...............XXXX.........
...................................
....................XXXXX..........
.........X.........................
.........XXX.......................
..........X........................
................XXXXX..............
...................................
...................................