...................................
...................................
......XXXXXX............X..........
......XXXXX..............X.........
......X....XXXXXXX.X..XXXX.........
...................................
....................XXXXX..........
.........X.X.......................
.........XXX.......................
.........X.XX......................
................XXXXX..............
...................................
...................................
